60s 5d
WWWWWWWWWWWWWWWWWWWWWWWWWWWW
WGGGGGGGGGGGGGGGGGGGGGGGDGGW
WGGGGGGGGGGGGGGGGGGGGGGGGGGW
W.GBBBGGGG...TT....GGGBGGGGW
WGGGBGGGGGGGBGGGGGGGGGGGDGGW
WGGGGGDGGGGGGGBDGGGGGGGGGGGW
WGGGGGGGGRGGGGGGGGGTTTTTTGGW
WTTTTTTGGGTTTTGGGGGGGGGGBGGW
WGGGBGGGGGGGGGGGGGGGGGGGBGGW
WGGGGGBGGGGGGGGGGGGGGGGGBGGW
WGBDGGBGGGBGGGGGGGGGGGGGBGGW
WGGGGGGGGGGGGG.....G.GGBGGGW
WG.GGBGGGGBGGGGGGGGG.GGBGGGW
WGB.GGGGGBBBGGGGGGGG..GGGGEW
WWWWWWWWWWWWWWWWWWWWWWWWWWWW